eco_name	oe_slug	oe_title
Admiralty Islands lowland rain forests	admiralty-islands-lowland-rainforests	Admiralty Islands Lowland Rainforests
Andaman Islands rain forests	andaman-islands-rainforests	Andaman Islands Rainforests
Bahia interior forests	bahia-interior-forests	Bahía Interior Forests
Biak-Numfoor rain forests	biak-numfoor-rainforests	Biak-Numfoor Rainforests
Borneo lowland rain forests	borneo-lowland-rainforests	Borneo Lowland Rainforests
Borneo montane rain forests	borneo-montane-rainforests	Borneo Montane Rainforests
Buru rain forests	buru-rainforests	Buru Rainforests
Cardamom Mountains rain forests	cardamom-mountains-rainforests	Cardamom Mountains Rainforests
Central Range Papuan montane rain forests	central-range-papuan-montane-rainforests	Central Range Papuan Montane Rainforests
Eastern Java-Bali montane rain forests	eastern-java-bali-montane-rainforests	Eastern Java–Bali Montane Rainforests
Eastern Java-Bali rain forests	eastern-java-bali-rainforests	Eastern Java-Bali Rainforests
Greater Negros-Panay rain forests	greater-negros-panay-rainforests	Greater Negros-Panay Rainforests
Hainan Island monsoon rain forests	hainan-island-monsoon-rainforests	Hainan Island Monsoon Rainforests
Halmahera rain forests	halmahera-rainforests	Halmahera Rainforests
Huon Peninsula montane rain forests	huon-peninsula-montane-rainforests	Huon Peninsula Montane Rainforests
Kayah-Karen montane rain forests	kayah-karen-montane-rainforests	Kayah-Karen Montane Rainforests
Louisiade Archipelago rain forests	louisiade-archipelago-rainforests	Louisiade Archipelago Rainforests
Luang Prabang montane rain forests	luang-prabang-montane-rainforests	Luang Prabang Montane Rainforests
Luzon montane rain forests	luzon-montane-rainforests	Luzon Montane Rainforests
Luzon rain forests	luzon-rainforests	Luzon Rainforests
Marañón dry forests	maranon-dry-forests	Marañon Dry Forests
Mentawai Islands rain forests	mentawai-islands-rainforests	Mentawai Islands Rainforests
Mindanao montane rain forests	mindanao-montane-rainforests	Mindanao Montane Rainforests
Mindanao-Eastern Visayas rain forests	mindanao-eastern-visayas-rainforests	Mindanao-Eastern Visayas Rainforests
Mindoro rain forests	mindoro-rainforests	Mindoro Rainforests
Mizoram-Manipur-Kachin rain forests	mizoram-manipur-kachin-rainforests	Mizoram-Manipur-Kachin Rainforests
Myanmar coastal rain forests	myanmar-coastal-rainforests	Myanmar Coastal Rainforests
New Britain-New Ireland lowland rain forests	new-britain-new-ireland-lowland-rainforests	New Britain-New Ireland Lowland Rainforests
New Britain-New Ireland montane rain forests	new-britain-new-ireland-montane-rainforests	New Britain-New Ireland Montane Rainforests
New Caledonia rain forests	new-caledonia-rainforests	New Caledonia Rainforests
Nicobar Islands rain forests	nicobar-islands-rainforests	Nicobar Islands Rainforests
North Western Ghats montane rain forests	north-western-ghats-montane-rainforests	North Western Ghats Montane Rainforests
Northern Annamites rain forests	northern-annamites-rainforests	Northern Annamites Rainforests
Northern New Guinea montane rain forests	northern-new-guinea-montane-rainforests	Northern New Guinea Montane Rainforests
Northern Vietnam lowland rain forests	northern-vietnam-lowland-rainforests	Northern Vietnam Lowland Rainforests
Palawan rain forests	palawan-rainforests	Palawan Rainforests
Pantepui forests & shrublands	pantepui-forests-and-shrublands	Pantepui Forests and Shrublands
Paraguaná xeric scrub	paraguana-xeric-scrub	Paraguana Xeric Scrub
Peninsular Malaysian montane rain forests	peninsular-malaysian-montane-rainforests	Peninsular Malaysian Montane Rainforests
Peninsular Malaysian rain forests	peninsular-malaysian-rainforests	Peninsular Malaysian Rainforests
Queen Charlotte Islands conifer forests	haida-gwaii-conifer-forests	Haida Gwaii Conifer Forests
Queensland tropical rain forests	queensland-tropical-rainforests	Queensland Tropical Rainforests
Santa Lucia Montane Chaparral & Woodlands	santa-lucia-montane-chaparral-and-woodlands	Santa Lucia Montane Chaparral and Woodlands
Seram rain forests	seram-rainforests	Seram Rainforests
Solomon Islands rain forests	solomon-islands-rainforests	Solomon Islands Rainforests
South Taiwan monsoon rain forests	south-taiwan-monsoon-rainforests	South Taiwan Monsoon Rainforests
South Western Ghats montane rain forests	south-western-ghats-montane-rainforests	South Western Ghats Montane Rainforests
Southern Annamites montane rain forests	southern-annamites-montane-rainforests	Southern Annamites Montane Rainforests
Southern New Guinea lowland rain forests	southern-new-guinea-lowland-rainforests	Southern New Guinea Lowland Rainforests
Sri Lanka lowland rain forests	sri-lanka-lowland-rainforests	Sri Lanka Lowland Rainforests
Sri Lanka montane rain forests	sri-lanka-montane-rainforests	Sri Lanka Montane Rainforests
Sulawesi lowland rain forests	sulawesi-lowland-rainforests	Sulawesi Lowland Rainforests
Sulawesi montane rain forests	sulawesi-montane-rainforests	Sulawesi Montane Rainforests
Sulu Archipelago rain forests	sulu-archipelago-rainforests	Sulu Archipelago Rainforests
Sumatran lowland rain forests	sumatran-lowland-rainforests	Sumatran Lowland Rainforests
Sumatran montane rain forests	sumatran-montane-rainforests	Sumatran Montane Rainforests
Tasmanian temperate rain forests	tasmanian-temperate-rainforests	Tasmanian Temperate Rainforests
Tenasserim-South Thailand semi-evergreen rain forests	tenasserim-south-thailand-semi-evergreen-rainforests	Tenasserim-South Thailand Semi-Evergreen Rainforests
Trobriand Islands rain forests	trobriand-islands-rainforests	Trobriand Islands Rainforests
Vanuatu rain forests	vanuatu-rainforests	Vanuatu Rainforests
Vogelkop montane rain forests	vogelkop-montane-rainforests	Vogelkop Montane Rainforests
Vogelkop-Aru lowland rain forests	vogelkop-aru-lowland-rainforests	Vogelkop-Aru Lowland Rainforests
Western Java montane rain forests	western-java-montane-rainforests	Western Java Montane Rainforests
Western Java rain forests	western-java-rainforests	Western Java Rainforests
Yapen rain forests	yapen-rainforests	Yapen Rainforests
Yucatán dry forests	yucatan-dry-forests	Yucatan Dry Forests
Yucatán moist forests	yucatan-moist-forests	Yucatan Moist Forests
North Saharan Xeric Steppe and Woodland	north-saharan-xeric-steppe-and-woodlands	North Saharan Xeric Steppe and Woodlands
Nujiang Langcang Gorge alpine conifer and mixed forests	nujiang-lancang-gorge-subalpine-conifer-and-mixed-forests	Nujiang Lancang Gorge Subalpine Conifer and Mixed Forests
Saharan halophytics	saharan-halophytic	Saharan Halophytic
Trinidad and Tobago dry forest	trinidad-and-tobago-dry-forests	Trinidad and Tobago Dry Forests
Cordillera La Costa montane forests	cordillera-de-la-costa-montane-forests	Cordillera de la Costa Montane Forests
Eastern Canadian Forest-Boreal transition	eastern-canadian-temperate-boreal-forest-transition	Eastern Canadian Temperate-Boreal Forest Transition
Eastern Canadian forests	eastern-canadian-boreal-forests	Eastern Canadian Boreal Forests
Eyre and York mallee	eyre-and-yorke-mallee	Eyre and Yorke Mallee
Interior Yukon-Alaska alpine tundra	interior-alaska-yukon-alpine-tundra	Interior Alaska-Yukon Alpine Tundra
Northeast Himalayan subalpine conifer forests	northeastern-himalayan-subalpine-conifer-forests	Northeastern Himalayan Subalpine Conifer Forests
Northeast Spain and Southern France Mediterranean forests	northeastern-spain-and-southern-france-mediterranean-forests	Northeastern Spain and Southern France Mediterranean Forests
Piney Woods	piney-woods-forests	Piney Woods Forests
Rapa Nui and Sala y Gómez subtropical forests	rapa-nui-and-sala-y-gomez-subtropical-broadleaf-forests	Rapa Nui and Sala Y Gómez Subtropical Broadleaf Forests
Southeast Iberian shrubs and woodlands	southeastern-iberian-shrubs-and-woodlands	Southeastern Iberian Shrubs and Woodlands
Southeast Indochina dry evergreen forests	southeastern-indochina-dry-evergreen-forests	Southeastern Indochina Dry Evergreen Forests
Southeast Papuan rain forests	southeastern-papuan-rainforests	Southeastern Papuan Rainforests
Tirari-Sturt stony desert	tirari-stuart-stony-desert	Tirari-Stuart Stony Desert
East Central Texas forests	east-central-texas-savanna-woodland	East Central Texas Savanna-Woodland
Southeast US mixed woodlands and savannas	southeast-us-conifer-savannas	Southeast US Conifer Savannas
Rock and Ice		
Serengeti volcanic grasslands		
