title	slug
Adelie Land Tundra	adelie-land-tundra
Admiralty Islands Lowland Rainforests	admiralty-islands-lowland-rainforests
Aegean and Western Turkey Sclerophyllous and Mixed Forests	aegean-and-western-turkey-sclerophyllous-and-mixed-forests
Afghan Mountains Semi-Desert	afghan-mountains-semi-desert
Ahklun and Kilbuck Upland Tundra	ahklun-and-kilbuck-upland-tundra
Al-Hajar Foothill Xeric Woodlands and Shrublands	al-hajar-foothill-xeric-woodlands-and-shrublands
Al-Hajar Montane Woodlands and Shrublands	al-hajar-montane-woodlands-and-shrublands
Alai-Western Tian Shan Steppe	alai-western-tian-shan-steppe
Alashan Plateau Semi-Desert	alashan-plateau-semi-desert
Alaska Peninsula Montane Taiga	alaska-peninsula-montane-taiga
Alaska-St. Elias Range Tundra	alaska-st-elias-range-tundra
Albany Thickets	albany-thickets
Alberta-British Columbia Foothills Forests	alberta-british-columbia-foothills-forests
Albertine Rift Montane Forests	albertine-rift-montane-forests
Aldabra Island Xeric Scrub	aldabra-island-xeric-scrub
Aleutian Islands Tundra	aleutian-islands-tundra
Allegheny Highlands Forests	allegheny-highlands-forests
Alps Conifer and Mixed Forests	alps-conifer-and-mixed-forests
Altai Alpine Meadow and Tundra	altai-alpine-meadow-and-tundra
Altai Montane Forest and Forest Steppe	altai-montane-forest-and-forest-steppe
Altai Steppe and Semi-Desert	altai-steppe-and-semi-desert
Alto Paraná Atlantic Forests	alto-parana-atlantic-forests
Amazon-Orinoco-Southern Caribbean Mangroves	amazon-orinoco-southern-caribbean-mangroves
Amsterdam-Saint Paul Islands Temperate Grasslands	amsterdam-saint-paul-islands-temperate-grasslands
Amur Meadow Steppe	amur-meadow-steppe
Anatolian Conifer and Deciduous Mixed Forests	anatolian-conifer-and-deciduous-mixed-forests
Andaman Islands Rainforests	andaman-islands-rainforests
Angolan Montane Forest-Grassland	angolan-montane-forest-grassland
Angolan Mopane Woodlands	angolan-mopane-woodlands
Angolan Scarp Savanna and Woodlands	angolan-scarp-savanna-and-woodlands
Angolan Wet Miombo Woodlands	angolan-wet-miombo-woodlands
Antipodes Subantarctic Islands Tundra	antipodes-subantarctic-islands-tundra
Appalachian Mixed Mesophytic Forests	appalachian-mixed-mesophytic-forests
Appalachian Piedmont Forests	appalachian-piedmont-forests
Appalachian-Blue Ridge forests	appalachian-blue-ridge-forests
Appenine Deciduous Montane Forests	appenine-deciduous-montane-forests
Apure-Villavicencio Dry Forests	apure-villavicencio-dry-forests
Arabian Desert	arabian-desert
Arabian Sand Desert	arabian-sand-desert
Arabian-Persian Gulf Coastal Plain Desert	arabian-persian-gulf-coastal-plain-desert
Araucaria Moist Forests	araucaria-moist-forests
Aravalli West Thorn Scrub Forests	aravalli-west-thorn-scrub-forests
Araya and Paria Xeric Scrub	araya-and-paria-xeric-scrub
Arctic Coastal Tundra	arctic-coastal-tundra
Arctic Foothills Tundra	arctic-foothills-tundra
Arizona Mountains Forests	arizona-mountains-forests
Arnhem Land Tropical Savanna	arnhem-land-tropical-savanna
Ascension Scrub and Grasslands	ascension-scrub-and-grasslands
Atacama Desert	atacama-desert
Atlantic Coast Restingas	atlantic-coast-restingas
Atlantic Coastal Pine Barrens	atlantic-coastal-pine-barrens
Australian Alps Montane Grasslands	australian-alps-montane-grasslands
Azerbaijan Shrub Desert and Steppe	azerbaijan-shrub-desert-and-steppe
Azores Temperate Mixed Forests	azores-temperate-mixed-forests
Badghyz and Karabil Semi-Desert	badghyz-and-karabil-semi-desert
Bahamian Pineyards	bahamian-pineyards
Bahamian-Antillean Mangroves	bahamian-antillean-mangroves
Bahia Coastal Forests	bahia-coastal-forests
Bahía Interior Forests	bahia-interior-forests
Baja California Desert	baja-california-desert
Bajío Dry Forests	bajio-dry-forests
Balkan Mixed Forests	balkan-mixed-forests
Balsas Dry Forests	balsas-dry-forests
Baltic Mixed Forests	baltic-mixed-forests
Baluchistan Xeric Woodlands	baluchistan-xeric-woodlands
Banda Sea Islands Moist Deciduous Forests	banda-sea-islands-moist-deciduous-forests
Belizian Pine Savannas	belizian-pine-savannas
Beni Savanna	beni-savanna
Beringia Lowland Tundra	beringia-lowland-tundra
Beringia Upland Tundra	beringia-upland-tundra
Bermuda Subtropical Conifer Forests	bermuda-subtropical-conifer-forests
Biak-Numfoor Rainforests	biak-numfoor-rainforests
Blue Mountains Forests	blue-mountains-forests
Bohai Sea Saline Meadow	bohai-sea-saline-meadow
Bolivian Montane Dry Forests	bolivian-montane-dry-forests
Bolivian Yungas	bolivian-yungas
Borneo Lowland Rainforests	borneo-lowland-rainforests
Borneo Montane Rainforests	borneo-montane-rainforests
Borneo Peat Swamp Forests	borneo-peat-swamp-forests
Brahmaputra Valley Semi-Evergreen Forests	brahmaputra-valley-semi-evergreen-forests
Brazilian Atlantic Dry Forests	brazilian-atlantic-dry-forests
Brigalow Tropical Savanna	brigalow-tropical-savanna
British Columbia Coastal Conifer Forests	british-columbia-coastal-conifer-forests
Brooks-British Range tundra	brooks-british-range-tundra
Buru Rainforests	buru-rainforests
Caatinga	caatinga
Caatinga Enclaves Moist Forests	caatinga-enclaves-moist-forests
Caledon Conifer Forests	caledon-conifer-forests
California Central Valley Grasslands	california-central-valley-grasslands
California Coastal Sage and Chaparral	california-coastal-sage-and-chaparral
California Interior Chaparral and Woodlands	california-interior-chaparral-and-woodlands
California Montane Chaparral and Woodlands	california-montane-chaparral-and-woodlands
Cameroon Highlands Forests	cameroon-highlands-forests
Campos Rupestres Montane Savanna	campos-rupestres-montane-savanna
Canadian Aspen Forests and Parklands	canadian-aspen-forests-and-parklands
Canadian High Arctic Tundra	canadian-high-arctic-tundra
Canadian Low Arctic Tundra	canadian-low-arctic-tundra
Canadian Middle Arctic Tundra	canadian-middle-arctic-tundra
Canary Islands Dry Woodlands and Forests	canary-islands-dry-woodlands-and-forests
Cantabrian Mixed Forests	cantabrian-mixed-forests
Canterbury-Otago Tussock Grasslands	canterbury-otago-tussock-grasslands
Cape Verde Islands Dry Forests	cape-verde-islands-dry-forests
Cape York Peninsula Tropical Savanna	cape-york-peninsula-tropical-savanna
Caqueta Moist Forests	caqueta-moist-forests
Cardamom Mountains Rainforests	cardamom-mountains-rainforests
Caribbean Shrublands	caribbean-shrublands
Carnarvon Xeric Shrublands	carnarvon-xeric-shrublands
Carolines Tropical Moist Forests	carolines-tropical-moist-forests
Carpathian Montane Forests	carpathian-montane-forests
Carpentaria Tropical Savanna	carpentaria-tropical-savanna
Caspian Hyrcanian Mixed Forests	caspian-hyrcanian-mixed-forests
Caspian Lowland Desert	caspian-lowland-desert
Catatumbo Moist Forests	catatumbo-moist-forests
Cauca Valley Dry Forests	cauca-valley-dry-forests
Cauca Valley Montane Forests	cauca-valley-montane-forests
Caucasus Mixed Forests	caucasus-mixed-forests
Cayos Miskitos-San Andrés and Providencia Moist Forests	cayos-miskitos-san-andres-and-providencia-moist-forests
Celtic Broadleaf Forests	celtic-broadleaf-forests
Central Afghan Mountains Xeric Woodlands	central-afghan-mountains-xeric-woodlands
Central African Mangroves	central-african-mangroves
Central American Atlantic Moist Forests	central-american-atlantic-moist-forests
Central American Dry Forests	central-american-dry-forests
Central American Montane Forests	central-american-montane-forests
Central American Pine-Oak Forests	central-american-pine-oak-forests
Central Anatolian Steppe	central-anatolian-steppe
Central Anatolian Steppe and Woodlands	central-anatolian-steppe-and-woodlands
Central Andean Dry Puna	central-andean-dry-puna
Central Andean Puna	central-andean-puna
Central Andean Wet Puna	central-andean-wet-puna
Central Asian Northern Desert	central-asian-northern-desert
Central Asian Riparian Woodlands	central-asian-riparian-woodlands
Central Asian Southern Desert	central-asian-southern-desert
Central British Columbia Mountain Forests	central-british-columbia-mountain-forests
Central Bushveld	central-bushveld
Central Canadian Shield Forests	central-canadian-shield-forests
Central China Loess Plateau Mixed Forests	central-china-loess-plateau-mixed-forests
Central Congolian Lowland Forests	central-congolian-lowland-forests
Central Deccan Plateau Dry Deciduous Forests	central-deccan-plateau-dry-deciduous-forests
Central European Mixed Forests	central-european-mixed-forests
Central Indochina Dry Forests	central-indochina-dry-forests
Central Korean Deciduous Forests	central-korean-deciduous-forests
Central Mexican Matorral	central-mexican-matorral
Central Pacific Northwest Coastal Forests	central-pacific-northwest-coastal-forests
Central Persian Desert Basins	central-persian-desert-basins
Central Polynesian Tropical Moist Forests	central-polynesian-tropical-moist-forests
Central Range Papuan Montane Rainforests	central-range-papuan-montane-rainforests
Central Ranges Xeric Scrub	central-ranges-xeric-scrub
Central South Antarctic Peninsula Tundra	central-south-antarctic-peninsula-tundra
Central Tallgrass Prairie	central-tallgrass-prairie
Central Tibetan Plateau Alpine Steppe	central-tibetan-plateau-alpine-steppe
Central US Forest-Grasslands Transition	central-us-forest-grasslands-transition
Central Zambezian Wet Miombo Woodlands	central-zambezian-wet-miombo-woodlands
Central-Southern Cascades Forests	central-southern-cascades-forests
Central-Southern US Mixed Grasslands	central-southern-us-mixed-grasslands
Cerrado	cerrado
Changbai Mountains Mixed Forests	changbai-mountains-mixed-forests
Changjiang Plain Evergreen Forests	changjiang-plain-evergreen-forests
Chao Phraya Freshwater Swamp Forests	chao-phraya-freshwater-swamp-forests
Chao Phraya Lowland Moist Deciduous Forests	chao-phraya-lowland-moist-deciduous-forests
Chatham Island Temperate Forests	chatham-island-temperate-forests
Cherskii-Kolyma Mountain Tundra	cherskii-kolyma-mountain-tundra
Chhota-Nagpur Dry Deciduous Forests	chhota-nagpur-dry-deciduous-forests
Chiapas Depression Dry Forests	chiapas-depression-dry-forests
Chiapas Montane Forests	chiapas-montane-forests
Chihuahuan Desert	chihuahuan-desert
Chilean Matorral	chilean-matorral
Chimalapas Montane Forests	chimalapas-montane-forests
Chin Hills-Arakan Yoma Montane Forests	chin-hills-arakan-yoma-montane-forests
Chiquitano Dry Forests	chiquitano-dry-forests
Chocó-Darién Moist Forests	choco-darien-moist-forests
Christmas and Cocos Islands Tropical Forests	christmas-and-cocos-islands-tropical-forests
Chukchi Peninsula Tundra	chukchi-peninsula-tundra
Clipperton Island Shrub and Grasslands	clipperton-island-shrub-and-grasslands
Cocos Island Moist Forests	cocos-island-moist-forests
Colorado Plateau Shrublands	colorado-plateau-shrublands
Colorado Rockies Forests	colorado-rockies-forests
Comoros Forests	comoros-forests
Congolian Coastal Forests	congolian-coastal-forests
Cook Inlet Taiga	cook-inlet-taiga
Cook Islands Tropical Moist Forests	cook-islands-tropical-moist-forests
Coolgardie Woodlands	coolgardie-woodlands
Copper Plateau Taiga	copper-plateau-taiga
Cordillera Central Páramo	cordillera-central-paramo
Cordillera de la Costa Montane Forests	cordillera-de-la-costa-montane-forests
Cordillera De Merida Páramo	cordillera-de-merida-paramo
Cordillera Oriental Montane Forests	cordillera-oriental-montane-forests
Corsican Montane Broadleaf and Mixed Forests	corsican-montane-broadleaf-and-mixed-forests
Costa Rican Seasonal Moist Forests	costa-rican-seasonal-moist-forests
Crete Mediterranean Forests	crete-mediterranean-forests
Crimean Submediterranean Forest Complex	crimean-submediterranean-forest-complex
Cross-Niger Transition Forests	cross-niger-transition-forests
Cross-Sanaga-Bioko Coastal Forests	cross-sanaga-bioko-coastal-forests
Cross-Timbers Savanna-Woodland	cross-timbers-savanna-woodland
Cuban Cactus Scrub	cuban-cactus-scrub
Cuban Dry Forests	cuban-dry-forests
Cuban Moist Forests	cuban-moist-forests
Cuban Pine Forests	cuban-pine-forests
Cuban Wetlands	cuban-wetlands
Cyprus Mediterranean Forests	cyprus-mediterranean-forests
Da Hinggan-Dzhagdy Mountains Conifer Forests	da-hinggan-dzhagdy-mountains-conifer-forests
Daba Mountains Evergreen Forests	daba-mountains-evergreen-forests
Daurian Forest Steppe	daurian-forest-steppe
Davis Highlands Tundra	davis-highlands-tundra
Deccan Thorn Scrub Forests	deccan-thorn-scrub-forests
Dinaric Mountains Mixed Forests	dinaric-mountains-mixed-forests
Djibouti Xeric Shrublands	djibouti-xeric-shrublands
Drakensberg Escarpment Savanna and Thicket	drakensberg-escarpment-savanna-and-thicket
Drakensberg Grasslands	drakensberg-grasslands
Dronning Maud Land Tundra	dronning-maud-land-tundra
Dry Chaco	dry-chaco
Dry Miombo Woodlands	dry-miombo-woodlands
East Afghan Montane Conifer Forests	east-afghan-montane-conifer-forests
East African Halophytics	east-african-halophytics
East African Mangroves	east-african-mangroves
East African Montane Forests	east-african-montane-forests
East African Montane Moorlands	east-african-montane-moorlands
East Antarctic Tundra	east-antarctic-tundra
East Arabian Fog Shrublands and Sand Desert	east-arabian-fog-shrublands-and-sand-desert
East Central Texas Savanna-Woodland	east-central-texas-savanna-woodland
East Deccan Dry-Evergreen Forests	east-deccan-dry-evergreen-forests
East Deccan Moist Deciduous Forests	east-deccan-moist-deciduous-forests
East European Forest Steppe	east-european-forest-steppe
East Sahara Desert	east-sahara-desert
East Saharan Montane Xeric Woodlands	east-saharan-montane-xeric-woodlands
East Siberian Taiga	east-siberian-taiga
East Sudanian Savanna	east-sudanian-savanna
Eastern Anatolian Deciduous Forests	eastern-anatolian-deciduous-forests
Eastern Anatolian Montane Steppe	eastern-anatolian-montane-steppe
Eastern Arc Forests	eastern-arc-forests
Eastern Australia Mulga Shrublands	eastern-australia-mulga-shrublands
Eastern Australian Temperate Forests	eastern-australian-temperate-forests
Eastern Canadian Boreal Forests	eastern-canadian-boreal-forests
Eastern Canadian Shield Taiga	eastern-canadian-shield-taiga
Eastern Canadian Temperate-Boreal Forest Transition	eastern-canadian-temperate-boreal-forest-transition
Eastern Cascades Forests	eastern-cascades-forests
Eastern Congolian Swamp Forests	eastern-congolian-swamp-forests
Eastern Cordillera Real Montane Forests	eastern-cordillera-real-montane-forests
Eastern Gobi Desert Steppe	eastern-gobi-desert-steppe
Eastern Great Lakes Lowland Forests	eastern-great-lakes-lowland-forests
Eastern Guinean Forests	eastern-guinean-forests
Eastern Himalayan Alpine Shrub and Meadows	eastern-himalayan-alpine-shrub-and-meadows
Eastern Himalayan Broadleaf Forests	eastern-himalayan-broadleaf-forests
Eastern Himalayan Subalpine Conifer Forests	eastern-himalayan-subalpine-conifer-forests
Eastern Java-Bali Rainforests	eastern-java-bali-rainforests
Eastern Java–Bali Montane Rainforests	eastern-java-bali-montane-rainforests
Eastern Mediterranean Conifer-Broadleaf Forests	eastern-mediterranean-conifer-broadleaf-forests
Eastern Micronesia Tropical Moist Forests	eastern-micronesia-tropical-moist-forests
Eastern Panamanian Montane Forests	eastern-panamanian-montane-forests
Ecuadorian Dry Forests	ecuadorian-dry-forests
Edwards Plateau Savanna	edwards-plateau-savanna
Einasleigh Upland Savanna	einasleigh-upland-savanna
Elburz Range Forest Steppe	elburz-range-forest-steppe
Ellsworth Land Tundra	ellsworth-land-tundra
Ellsworth Mountains Tundra	ellsworth-mountains-tundra
Emin Valley Steppe	emin-valley-steppe
Enderby Land Tundra	enderby-land-tundra
English Lowlands Beech Forests	english-lowlands-beech-forests
Enriquillo Wetlands	enriquillo-wetlands
Eritrean Coastal Desert	eritrean-coastal-desert
Esperance Mallee	esperance-mallee
Espinal	espinal
Ethiopian Montane Forests	ethiopian-montane-forests
Ethiopian Montane Grasslands and Woodlands	ethiopian-montane-grasslands-and-woodlands
Ethiopian Montane Moorlands	ethiopian-montane-moorlands
Etosha Pan Halophytics	etosha-pan-halophytics
European Atlantic Mixed Forests	european-atlantic-mixed-forests
Euxine-Colchic Broadleaf Forests	euxine-colchic-broadleaf-forests
Everglades Flooded Grasslands	everglades-flooded-grasslands
Eyre and Yorke Mallee	eyre-and-yorke-mallee
Faroe Islands Boreal Grasslands	faroe-islands-boreal-grasslands
Fernando De Noronha-Atol Das Rocas Moist Forests	fernando-de-noronha-atol-das-rocas-moist-forests
Fiji Tropical Dry Forests	fiji-tropical-dry-forests
Fiji Tropical Moist Forests	fiji-tropical-moist-forests
Fiordland Temperate Forests	fiordland-temperate-forests
Flinders-Lofty Montane Woodlands	flinders-lofty-montane-woodlands
Flint Hills Tallgrass Prairie	flint-hills-tallgrass-prairie
Fraser Plateau and Basin Conifer Forests	fraser-plateau-and-basin-conifer-forests
Fynbos Shrubland	fynbos-shrubland
Galápagos Islands Xeric Scrub	galapagos-islands-xeric-scrub
Gariep Karoo	gariep-karoo
Ghorat-Hazarajat Alpine Meadow	ghorat-hazarajat-alpine-meadow
Gibson Desert	gibson-desert
Gissaro-Alai Open Woodlands	gissaro-alai-open-woodlands
Gobi Lakes Valley Desert Steppe	gobi-lakes-valley-desert-steppe
Godavari-Krishna Mangroves	godavari-krishna-mangroves
Granitic Seychelles Forests	granitic-seychelles-forests
Great Basin Montane Forests	great-basin-montane-forests
Great Basin Shrub Steppe	great-basin-shrub-steppe
Great Lakes Basin Desert Steppe	great-lakes-basin-desert-steppe
Great Sandy-Tanami Desert	great-sandy-tanami-desert
Great Victoria Desert	great-victoria-desert
Greater Negros-Panay Rainforests	greater-negros-panay-rainforests
Guajira-Barranquilla Xeric Scrub	guajira-barranquilla-xeric-scrub
Guayaquil Flooded Grasslands	guayaquil-flooded-grasslands
Guianan Freshwater Swamp Forests	guianan-freshwater-swamp-forests
Guianan Highlands Moist Forests	guianan-highlands-moist-forests
Guianan Lowland Moist Forests	guianan-lowland-moist-forests
Guianan Piedmont Moist Forests	guianan-piedmont-moist-forests
Guianan Savanna	guianan-savanna
Guinean Forest-Savanna	guinean-forest-savanna
Guinean Mangroves	guinean-mangroves
Guinean Montane Forests	guinean-montane-forests
Guizhou Plateau Broadleaf and Mixed Forests	guizhou-plateau-broadleaf-and-mixed-forests
Gulf of California Xeric Scrub	gulf-of-california-xeric-scrub
Gulf of St. Lawrence Lowland Forests	gulf-of-st-lawrence-lowland-forests
Gurupa Várzea	gurupa-varzea
Haida Gwaii Conifer Forests	haida-gwaii-conifer-forests
Hainan Island Monsoon Rainforests	hainan-island-monsoon-rainforests
Halmahera Rainforests	halmahera-rainforests
Hampton Mallee and Woodlands	hampton-mallee-and-woodlands
Hawai'I Tropical Dry Forests	hawaii-tropical-dry-forests
Hawai'i Tropical High Shrublands	hawaii-tropical-high-shrublands
Hawai'I Tropical Low Shrublands	hawaii-tropical-low-shrublands
Hawai'I Tropical Moist Forests	hawaii-tropical-moist-forests
Helanshan Montane Conifer Forests	helanshan-montane-conifer-forests
Hengduan Mountains Subalpine Conifer Forests	hengduan-mountains-subalpine-conifer-forests
High Monte	high-monte
Highveld Grasslands	highveld-grasslands
Himalayan Subtropical Broadleaf Forests	himalayan-subtropical-broadleaf-forests
Himalayan Subtropical Pine Forests	himalayan-subtropical-pine-forests
Hindu Kush Alpine Meadow	hindu-kush-alpine-meadow
Hispaniolan Dry Forests	hispaniolan-dry-forests
Hispaniolan Moist Forests	hispaniolan-moist-forests
Hispaniolan Pine Forests	hispaniolan-pine-forests
Hobyo Grasslands and Shrublands	hobyo-grasslands-and-shrublands
Hokkaido Deciduous Forests	hokkaido-deciduous-forests
Hokkaido Montane Conifer Forests	hokkaido-montane-conifer-forests
Honshu Alpine Conifer Forests	honshu-alpine-conifer-forests
Horn of Africa Xeric Bushlands	horn-of-africa-xeric-bushlands
Huang He Plain Mixed Forests	huang-he-plain-mixed-forests
Humid Chaco	humid-chaco
Humid Pampas	humid-pampas
Huon Peninsula Montane Rainforests	huon-peninsula-montane-rainforests
Iberian Conifer Forests	iberian-conifer-forests
Iberian Sclerophyllous and Semi-Deciduous Forests	iberian-sclerophyllous-and-semi-deciduous-forests
Iceland Boreal Birch Forests and Alpine Tundra	iceland-boreal-birch-forests-and-alpine-tundra
Ile Europa and Bassas Da India Xeric Scrub	ile-europa-and-bassas-da-india-xeric-scrub
Illyrian Deciduous Forests	illyrian-deciduous-forests
Indochina Mangroves	indochina-mangroves
Indus River Delta-Arabian Sea Mangroves	indus-river-delta-arabian-sea-mangroves
Indus Valley Desert	indus-valley-desert
Inner Niger Delta Flooded Savanna	inner-niger-delta-flooded-savanna
Interior Alaska-Yukon Alpine Tundra	interior-alaska-yukon-alpine-tundra
Interior Alaska-Yukon Lowland Taiga	interior-alaska-yukon-lowland-taiga
Interior Plateau US Hardwood Forests	interior-plateau-us-hardwood-forests
Iquitos Várzea	iquitos-varzea
Irrawaddy Dry Forests	irrawaddy-dry-forests
Irrawaddy Freshwater Swamp Forests	irrawaddy-freshwater-swamp-forests
Irrawaddy Moist Deciduous Forests	irrawaddy-moist-deciduous-forests
Islas Revillagigedo Dry Forests	islas-revillagigedo-dry-forests
Isthmian-Atlantic Moist Forests	isthmian-atlantic-moist-forests
Isthmian-Pacific Moist Forests	isthmian-pacific-moist-forests
Italian Sclerophyllous and Semi-Deciduous Forests	italian-sclerophyllous-and-semi-deciduous-forests
Itigi-Sumbu Thicket	itigi-sumbu-thicket
Jalisco Dry Forests	jalisco-dry-forests
Jamaican Dry Forests	jamaican-dry-forests
Jamaican Moist Forests	jamaican-moist-forests
Japurá-Solimões-Negro Moist Forests	japura-solimoes-negro-moist-forests
Jarrah-Karri Forest and Shrublands	jarrah-karri-forest-and-shrublands
Jian Nan Subtropical Evergreen Forests	jian-nan-subtropical-evergreen-forests
Jos Plateau Forest-Grassland	jos-plateau-forest-grassland
Juan Fernández Islands Temperate Forests	juan-fernandez-islands-temperate-forests
Junggar Basin Semi-Desert	junggar-basin-semi-desert
Juruá-Purus Moist Forests	jurua-purus-moist-forests
Kalaallit Nunaat Arctic Steppe	kalaallit-nunaat-arctic-steppe
Kalaallit Nunaat High Arctic Tundra	kalaallit-nunaat-high-arctic-tundra
Kalahari Acacia Woodlands	kalahari-acacia-woodlands
Kalahari Xeric Savanna	kalahari-xeric-savanna
Kamchatka Taiga	kamchatka-taiga
Kamchatka Tundra	kamchatka-tundra
Kamchatka-Kurile Meadows and Sparse Forests	kamchatka-kurile-meadows-and-sparse-forests
Kaokoveld Desert	kaokoveld-desert
Karakoram-West Tibetan Plateau Alpine Steppe	karakoram-west-tibetan-plateau-alpine-steppe
Kayah-Karen Montane Rainforests	kayah-karen-montane-rainforests
Kazakh Forest Steppe	kazakh-forest-steppe
Kazakh Semi-Desert	kazakh-semi-desert
Kazakh Steppe	kazakh-steppe
Kazakh Upland Steppe	kazakh-upland-steppe
Kermadec Islands Subtropical Moist Forests	kermadec-islands-subtropical-moist-forests
Khangai Mountains Alpine Meadow	khangai-mountains-alpine-meadow
Khangai Mountains Conifer Forests	khangai-mountains-conifer-forests
Khathiar-Gir Dry Deciduous Forests	khathiar-gir-dry-deciduous-forests
Kimberly Tropical Savanna	kimberly-tropical-savanna
Kinabalu Montane Alpine Meadows	kinabalu-montane-alpine-meadows
Klamath-Siskiyou Forests	klamath-siskiyou-forests
Knysna-Amatole Montane Forests	knysna-amatole-montane-forests
Kola Peninsula Tundra	kola-peninsula-tundra
Kopet Dag Semi-Desert	kopet-dag-semi-desert
Kopet Dag Woodlands and Forest Steppe	kopet-dag-woodlands-and-forest-steppe
Kuh Rud and Eastern Iran Montane Woodlands	kuh-rud-and-eastern-iran-montane-woodlands
Kwazulu Natal-Cape Coastal Forests	kwazulu-natal-cape-coastal-forests
La Costa Xeric Shrublands	la-costa-xeric-shrublands
Lake Chad Flooded Savanna	lake-chad-flooded-savanna
Lara-Falcón Dry Forests	lara-falcon-dry-forests
Leeward Islands Moist Forests	leeward-islands-moist-forests
Lesser Antillean Dry Forests	lesser-antillean-dry-forests
Lesser Sundas Deciduous Forests	lesser-sundas-deciduous-forests
Limpopo Lowveld	limpopo-lowveld
Llanos	llanos
Lord Howe Island Subtropical Forests	lord-howe-island-subtropical-forests
Louisiade Archipelago Rainforests	louisiade-archipelago-rainforests
Low Monte	low-monte
Lower Gangetic Plains Moist Deciduous Forests	lower-gangetic-plains-moist-deciduous-forests
Luang Prabang Montane Rainforests	luang-prabang-montane-rainforests
Luzon Montane Rainforests	luzon-montane-rainforests
Luzon Rainforests	luzon-rainforests
Luzon Tropical Pine Forests	luzon-tropical-pine-forests
Madagascar Dry Deciduous Forests	madagascar-dry-deciduous-forests
Madagascar Ericoid Thickets	madagascar-ericoid-thickets
Madagascar Humid Forests	madagascar-humid-forests
Madagascar Mangroves	madagascar-mangroves
Madagascar Spiny Thickets	madagascar-spiny-thickets
Madagascar Subhumid Forests	madagascar-subhumid-forests
Madagascar Succulent Woodlands	madagascar-succulent-woodlands
Madeira Evergreen Forests	madeira-evergreen-forests
Madeira-Tapajós Moist Forests	madeira-tapajos-moist-forests
Magdalena Valley Dry Forests	magdalena-valley-dry-forests
Magdalena Valley Montane Forests	magdalena-valley-montane-forests
Magdalena-Urabá Moist Forests	magdalena-uraba-moist-forests
Magellanic Subpolar Forests	magellanic-subpolar-forests
Makgadikgadi Halophytics	makgadikgadi-halophytics
Malabar Coast Moist Forests	malabar-coast-moist-forests
Maldives-Lakshadweep-Chagos Archipelago Tropical Moist Forests	maldives-lakshadweep-chagos-archipelago-tropical-moist-forests
Malpelo Island Xeric Scrub	malpelo-island-xeric-scrub
Manchurian Mixed Forests	manchurian-mixed-forests
Mandara Plateau Woodlands	mandara-plateau-woodlands
Maputaland Coastal Forests and Woodlands	maputaland-coastal-forests-and-woodlands
Maracaibo Dry Forests	maracaibo-dry-forests
Marajó Várzea	marajo-varzea
Maranhão Babaçu Forests	maranhao-babacu-forests
Marañon Dry Forests	maranon-dry-forests
Marianas Tropical Dry Forests	marianas-tropical-dry-forests
Marie Byrd Land Tundra	marie-byrd-land-tundra
Marquesas Tropical Moist Forests	marquesas-tropical-moist-forests
Masai Xeric Grasslands and Shrublands	masai-xeric-grasslands-and-shrublands
Mascarene Forests	mascarene-forests
Mato Grosso Tropical Dry Forests	mato-grosso-tropical-dry-forests
Mediterranean Acacia-Argania Dry Woodlands and Succulent Thickets	mediterranean-acacia-argania-dry-woodlands-and-succulent-thickets
Mediterranean Conifer and Mixed Forests	mediterranean-conifer-and-mixed-forests
Mediterranean Dry Woodlands and Steppe	mediterranean-dry-woodlands-and-steppe
Mediterranean High Atlas Juniper Steppe	mediterranean-high-atlas-juniper-steppe
Mediterranean Woodlands and Forests	mediterranean-woodlands-and-forests
Meghalaya Subtropical Forests	meghalaya-subtropical-forests
Mentawai Islands Rainforests	mentawai-islands-rainforests
Meseta Central Matorral	meseta-central-matorral
Mesoamerican Gulf-Caribbean Mangroves	mesoamerican-gulf-caribbean-mangroves
Mesopotamian Shrub Desert	mesopotamian-shrub-desert
Mid-Atlantic US Coastal Savannas	mid-atlantic-us-coastal-savannas
Mid-Canada Boreal Plains Forests	mid-canada-boreal-plains-forests
Midwest Canadian Shield Forests	midwest-canadian-shield-forests
Mindanao Montane Rainforests	mindanao-montane-rainforests
Mindanao-Eastern Visayas Rainforests	mindanao-eastern-visayas-rainforests
Mindoro Rainforests	mindoro-rainforests
Miskito Pine Forests	miskito-pine-forests
Mississippi Lowland Forests	mississippi-lowland-forests
Mitchell Grass Downs	mitchell-grass-downs
Mizoram-Manipur-Kachin Rainforests	mizoram-manipur-kachin-rainforests
Mojave Desert	mojave-desert
Mongolian-Manchurian Grassland	mongolian-manchurian-grassland
Montana Valley and Foothill Grasslands	montana-valley-and-foothill-grasslands
Monte Alegre Várzea	monte-alegre-varzea
Motagua Valley Thornscrub	motagua-valley-thornscrub
Mount Cameroon and Bioko Montane Forests	mount-cameroon-and-bioko-montane-forests
Mulanje Montane Forest-Grassland	mulanje-montane-forest-grassland
Murray-Darling Woodlands and Mallee	murray-darling-woodlands-and-mallee
Muskwa-Slave Lake Taiga	muskwa-slave-lake-taiga
Myanmar Coast Mangroves	myanmar-coast-mangroves
Myanmar Coastal Rainforests	myanmar-coastal-rainforests
Nama Karoo Shrublands	nama-karoo-shrublands
Namaqualand-Richtersveld Steppe	namaqualand-richtersveld-steppe
Namib Desert	namib-desert
Namibian Savanna Woodlands	namibian-savanna-woodlands
Nansei Islands Subtropical Evergreen Forests	nansei-islands-subtropical-evergreen-forests
Napo Moist Forests	napo-moist-forests
Naracoorte Woodlands	naracoorte-woodlands
Narmada Valley Dry Deciduous Forests	narmada-valley-dry-deciduous-forests
Nebraska Sand Hills Mixed Grasslands	nebraska-sand-hills-mixed-grasslands
Negro-Branco Moist Forests	negro-branco-moist-forests
Nelson Coast Temperate Forests	nelson-coast-temperate-forests
Nenjiang River Grassland	nenjiang-river-grassland
New Britain-New Ireland Lowland Rainforests	new-britain-new-ireland-lowland-rainforests
New Britain-New Ireland Montane Rainforests	new-britain-new-ireland-montane-rainforests
New Caledonia Dry Forests	new-caledonia-dry-forests
New Caledonia Rainforests	new-caledonia-rainforests
New England-Acadian Forests	new-england-acadian-forests
New Guinea Mangroves	new-guinea-mangroves
New Zealand North Island Temperate Forests	new-zealand-north-island-temperate-forests
New Zealand South Island Montane Grasslands	new-zealand-south-island-montane-grasslands
New Zealand South Island Temperate Forests	new-zealand-south-island-temperate-forests
Nicobar Islands Rainforests	nicobar-islands-rainforests
Niger Delta Swamp Forests	niger-delta-swamp-forests
Nigerian Lowland Forests	nigerian-lowland-forests
Nihonkai Evergreen Forests	nihonkai-evergreen-forests
Nihonkai Montane Deciduous Forests	nihonkai-montane-deciduous-forests
Nile Delta Flooded Savanna	nile-delta-flooded-savanna
Norfolk Island Subtropical Forests	norfolk-island-subtropical-forests
North Arabian Desert	north-arabian-desert
North Arabian Highland Shrublands	north-arabian-highland-shrublands
North Atlantic Moist Mixed Forests	north-atlantic-moist-mixed-forests
North Cascades Conifer Forests	north-cascades-conifer-forests
North Deccan Dry Deciduous Forests	north-deccan-dry-deciduous-forests
North Saharan Xeric Steppe and Woodlands	north-saharan-xeric-steppe-and-woodlands
North Tibetan Plateau-Kunlun Mountains Alpine Desert	north-tibetan-plateau-kunlun-mountains-alpine-desert
North Victoria Land Tundra	north-victoria-land-tundra
North Western Ghats Moist Deciduous Forests	north-western-ghats-moist-deciduous-forests
North Western Ghats Montane Rainforests	north-western-ghats-montane-rainforests
Northeast Antarctic Peninsula Tundra	northeast-antarctic-peninsula-tundra
Northeast Brazil Restingas	northeast-brazil-restingas
Northeast China Plain Deciduous Forests	northeast-china-plain-deciduous-forests
Northeast Congolian Lowland Forests	northeast-congolian-lowland-forests
Northeast India-Myanmar Pine Forests	northeast-india-myanmar-pine-forests
Northeast Siberian Coastal Tundra	northeast-siberian-coastal-tundra
Northeast Siberian Taiga	northeast-siberian-taiga
Northeast US Coastal Forests	northeast-us-coastal-forests
Northeastern Himalayan Subalpine Conifer Forests	northeastern-himalayan-subalpine-conifer-forests
Northeastern Spain and Southern France Mediterranean Forests	northeastern-spain-and-southern-france-mediterranean-forests
Northern Acacia-Commiphora Bushlands and Thickets	northern-acacia-commiphora-bushlands-and-thickets
Northern Anatolian Conifer and Deciduous Forests	northern-anatolian-conifer-and-deciduous-forests
Northern Andean Páramo	northern-andean-paramo
Northern Annamites Rainforests	northern-annamites-rainforests
Northern California Coastal Forests	northern-california-coastal-forests
Northern Canadian Shield Taiga	northern-canadian-shield-taiga
Northern Congolian Forest-Savanna	northern-congolian-forest-savanna
Northern Cordillera Forests	northern-cordillera-forests
Northern Indochina Subtropical Forests	northern-indochina-subtropical-forests
Northern Khorat Plateau Moist Deciduous Forests	northern-khorat-plateau-moist-deciduous-forests
Northern Mesoamerican Pacific Mangroves	northern-mesoamerican-pacific-mangroves
Northern New Guinea Lowland Rain and Freshwater Swamp Forests	northern-new-guinea-lowland-rain-and-freshwater-swamp-forests
Northern New Guinea Montane Rainforests	northern-new-guinea-montane-rainforests
Northern Pacific Alaskan Coastal Forests	northern-pacific-alaskan-coastal-forests
Northern Rockies Conifer Forests	northern-rockies-conifer-forests
Northern Shortgrass Prairie	northern-shortgrass-prairie
Northern Swahili Coastal Forests	northern-swahili-coastal-forests
Northern Tallgrass Prairie	northern-tallgrass-prairie
Northern Thailand-Laos Moist Deciduous Forests	northern-thailand-laos-moist-deciduous-forests
Northern Triangle Subtropical Forests	northern-triangle-subtropical-forests
Northern Triangle Temperate Forests	northern-triangle-temperate-forests
Northern Vietnam Lowland Rainforests	northern-vietnam-lowland-rainforests
Northland Temperate Kauri Forests	northland-temperate-kauri-forests
Northwest Andean Montane Forests	northwest-andean-montane-forests
Northwest Antarctic Peninsula Tundra	northwest-antarctic-peninsula-tundra
Northwest Congolian Lowland Forests	northwest-congolian-lowland-forests
Northwest Hawai'I Scrub	northwest-hawaii-scrub
Northwest Iberian Montane Forests	northwest-iberian-montane-forests
Northwest Russian-Novaya Zemlya Tundra	northwest-russian-novaya-zemlya-tundra
Northwest Territories Taiga	northwest-territories-taiga
Northwestern Himalayan Alpine Shrub and Meadows	northwestern-himalayan-alpine-shrub-and-meadows
Novosibirsk Islands Arctic Desert	novosibirsk-islands-arctic-desert
Nujiang Lancang Gorge Subalpine Conifer and Mixed Forests	nujiang-lancang-gorge-subalpine-conifer-and-mixed-forests
Nullarbor Plains Xeric Shrublands	nullarbor-plains-xeric-shrublands
Nyanga-Chimanimani Montane Forest-Grassland	nyanga-chimanimani-montane-forest-grassland
Oaxacan Montane Forests	oaxacan-montane-forests
Ogasawara Subtropical Moist Forests	ogasawara-subtropical-moist-forests
Ogilvie-Mackenzie Alpine Tundra	ogilvie-mackenzie-alpine-tundra
Okanogan Dry Forests	okanogan-dry-forests
Okhotsk-Manchurian Taiga	okhotsk-manchurian-taiga
Ordos Plateau Steppe	ordos-plateau-steppe
Orinoco Delta Swamp Forests	orinoco-delta-swamp-forests
Orinoco Wetlands	orinoco-wetlands
Orissa Semi-Evergreen Forests	orissa-semi-evergreen-forests
Ozark Highlands Mixed Forests	ozark-highlands-mixed-forests
Ozark Mountain Forests	ozark-mountain-forests
Pacific Coastal Mountain Icefields and Tundra	pacific-coastal-mountain-icefields-and-tundra
Palau Tropical Moist Forests	palau-tropical-moist-forests
Palawan Rainforests	palawan-rainforests
Palouse Prairie	palouse-prairie
Pamir Alpine Desert and Tundra	pamir-alpine-desert-and-tundra
Panamanian Dry Forests	panamanian-dry-forests
Pannonian Mixed Forests	pannonian-mixed-forests
Pantanal	pantanal
Pantanos De Centla	pantanos-de-centla
Pantepui Forests and Shrublands	pantepui-forests-and-shrublands
Papuan Central Range Sub-Alpine Grasslands	papuan-central-range-sub-alpine-grasslands
Paraguana Xeric Scrub	paraguana-xeric-scrub
Paraná Flooded Savanna	parana-flooded-savanna
Paropamisus Xeric Woodlands	paropamisus-xeric-woodlands
Patagonian Steppe	patagonian-steppe
Patía valley dry forests	patia-valley-dry-forests
Peninsular Malaysian Montane Rainforests	peninsular-malaysian-montane-rainforests
Peninsular Malaysian Peat Swamp Forests	peninsular-malaysian-peat-swamp-forests
Peninsular Malaysian Rainforests	peninsular-malaysian-rainforests
Pernambuco Coastal Forests	pernambuco-coastal-forests
Pernambuco Interior Forests	pernambuco-interior-forests
Peruvian Yungas	peruvian-yungas
Petén-Veracruz Moist Forests	peten-veracruz-moist-forests
Pilbara Shrublands	pilbara-shrublands
Pindus Mountains Mixed Forests	pindus-mountains-mixed-forests
Piney Woods Forests	piney-woods-forests
Po Basin Mixed Forests	po-basin-mixed-forests
Pontic Steppe	pontic-steppe
Prince Charles Mountains Tundra	prince-charles-mountains-tundra
Puerto Rican Dry Forests	puerto-rican-dry-forests
Puerto Rican Moist Forests	puerto-rican-moist-forests
Puget Lowland Forests	puget-lowland-forests
Purus Várzea	purus-varzea
Purus-Madeira Moist Forests	purus-madeira-moist-forests
Pyrenees Conifer and Mixed Forests	pyrenees-conifer-and-mixed-forests
Qaidam Basin Semi-Desert	qaidam-basin-semi-desert
Qilian Mountains Conifer Forests	qilian-mountains-conifer-forests
Qilian Mountains Subalpine Meadows	qilian-mountains-subalpine-meadows
Qin Ling Mountains Deciduous Forests	qin-ling-mountains-deciduous-forests
Qionglai-Minshan Conifer Forests	qionglai-minshan-conifer-forests
Queensland Tropical Rainforests	queensland-tropical-rainforests
Rakiura Island Temperate Forests	rakiura-island-temperate-forests
Rann of Kutch Seasonal Salt Marsh	rann-of-kutch-seasonal-salt-marsh
Rapa Nui and Sala Y Gómez Subtropical Broadleaf Forests	rapa-nui-and-sala-y-gomez-subtropical-broadleaf-forests
Red River Freshwater Swamp Forests	red-river-freshwater-swamp-forests
Red Sea Coastal Desert	red-sea-coastal-desert
Red Sea Mangroves	red-sea-mangroves
Red Sea-Arabian Desert Shrublands	red-sea-arabian-desert-shrublands
Registan-North Pakistan Sandy Desert	registan-north-pakistan-sandy-desert
Renosterveld Shrubland	renosterveld-shrubland
Richmond Temperate Forests	richmond-temperate-forests
Rio Negro Campinarana	rio-negro-campinarana
Rodope Montane Mixed Forests	rodope-montane-mixed-forests
Russian Arctic Desert	russian-arctic-desert
Russian Bering Tundra	russian-bering-tundra
Rwenzori-Virunga Montane Moorlands	rwenzori-virunga-montane-moorlands
Saharan Atlantic Coastal Desert	saharan-atlantic-coastal-desert
Saharan Halophytic	saharan-halophytic
Sahelian Acacia Savanna	sahelian-acacia-savanna
Sakhalin Island Taiga	sakhalin-island-taiga
Samoan Tropical Moist Forests	samoan-tropical-moist-forests
San Félix-San Ambrosio Islands Temperate Forests	san-felix-san-ambrosio-islands-temperate-forests
San Lucan Xeric Scrub	san-lucan-xeric-scrub
Santa Lucia Montane Chaparral and Woodlands	santa-lucia-montane-chaparral-and-woodlands
Santa Marta Montane Forests	santa-marta-montane-forests
Santa Marta Páramo	santa-marta-paramo
São Tomé, Príncipe, and Annobón Forests	sao-tome-principe-and-annobon-forests
Sarmatic Mixed Forests	sarmatic-mixed-forests
Sayan Alpine Meadows and Tundra	sayan-alpine-meadows-and-tundra
Sayan Intermontane Steppe	sayan-intermontane-steppe
Sayan Montane Conifer Forests	sayan-montane-conifer-forests
Scandinavian and Russian Taiga	scandinavian-and-russian-taiga
Scandinavian Coastal Conifer Forests	scandinavian-coastal-conifer-forests
Scandinavian Montane Birch Forest and Grasslands	scandinavian-montane-birch-forest-and-grasslands
Scotia Sea Islands Tundra	scotia-sea-islands-tundra
Sechura Desert	sechura-desert
Selenge-Orkhon Forest Steppe	selenge-orkhon-forest-steppe
Seram Rainforests	seram-rainforests
Serra Do Mar Coastal Forests	serra-do-mar-coastal-forests
Sichuan Basin Evergreen Broadleaf Forests	sichuan-basin-evergreen-broadleaf-forests
Sierra de la Laguna Dry Forests	sierra-de-la-laguna-dry-forests
Sierra de la Laguna Pine-Oak Forests	sierra-de-la-laguna-pine-oak-forests
Sierra De Los Tuxtlas	sierra-de-los-tuxtlas
Sierra Madre De Chiapas Moist Forests	sierra-madre-de-chiapas-moist-forests
Sierra Madre De Oaxaca Pine-Oak Forests	sierra-madre-de-oaxaca-pine-oak-forests
Sierra Madre Del Sur Pine-Oak Forests	sierra-madre-del-sur-pine-oak-forests
Sierra Madre Occidental Pine-Oak Forests	sierra-madre-occidental-pine-oak-forests
Sierra Madre Oriental Pine-Oak Forests	sierra-madre-oriental-pine-oak-forests
Sierra Nevada Forests	sierra-nevada-forests
Simpson Desert	simpson-desert
Sinaloan Dry Forests	sinaloan-dry-forests
Sinú Valley Dry Forests	sinu-valley-dry-forests
Snake-Columbia Shrub Steppe	snake-columbia-shrub-steppe
Society Islands Tropical Moist Forests	society-islands-tropical-moist-forests
Socotra Island Xeric Shrublands	socotra-island-xeric-shrublands
Solimões-Japurá Moist Forests	solimoes-japura-moist-forests
Solomon Islands Rainforests	solomon-islands-rainforests
Somali Acacia-Commiphora Bushlands and Thickets	somali-acacia-commiphora-bushlands-and-thickets
Somali Montane Xeric Woodlands	somali-montane-xeric-woodlands
Sonoran Desert	sonoran-desert
Sonoran-Sinaloan Subtropical Dry Forest	sonoran-sinaloan-subtropical-dry-forest
South American Pacific Mangroves	south-american-pacific-mangroves
South Antarctic Peninsula Tundra	south-antarctic-peninsula-tundra
South Apennine Mixed Montane Forests	south-apennine-mixed-montane-forests
South Arabian Fog Woodlands, Shrublands, and Dune	south-arabian-fog-woodlands-shrublands-and-dune
South Arabian Plains and Plateau Desert	south-arabian-plains-and-plateau-desert
South Central Rockies Forests	south-central-rockies-forests
South China Sea Islands	south-china-sea-islands
South China-Vietnam Subtropical Evergreen Forests	south-china-vietnam-subtropical-evergreen-forests
South Deccan Plateau Dry Deciduous Forests	south-deccan-plateau-dry-deciduous-forests
South Iran Nubo-Sindian Desert and Semi-Desert	south-iran-nubo-sindian-desert-and-semi-desert
South Orkney Islands Tundra	south-orkney-islands-tundra
South Sahara Desert	south-sahara-desert
South Siberian Forest Steppe	south-siberian-forest-steppe
South Taiwan Monsoon Rainforests	south-taiwan-monsoon-rainforests
South Victoria Land Tundra	south-victoria-land-tundra
South Western Ghats Moist Deciduous Forests	south-western-ghats-moist-deciduous-forests
South Western Ghats Montane Rainforests	south-western-ghats-montane-rainforests
Southeast Australia Temperate Forests	southeast-australia-temperate-forests
Southeast Australia Temperate Savanna	southeast-australia-temperate-savanna
Southeast Tibet Shrublands and Meadows	southeast-tibet-shrublands-and-meadows
Southeast US Conifer Savannas	southeast-us-conifer-savannas
Southeastern Iberian Shrubs and Woodlands	southeastern-iberian-shrubs-and-woodlands
Southeastern Indochina Dry Evergreen Forests	southeastern-indochina-dry-evergreen-forests
Southeastern Papuan Rainforests	southeastern-papuan-rainforests
Southern Acacia-Commiphora Bushlands and Thickets	southern-acacia-commiphora-bushlands-and-thickets
Southern Africa Mangroves	southern-africa-mangroves
Southern Anatolian Montane Conifer and Deciduous Forests	southern-anatolian-montane-conifer-and-deciduous-forests
Southern Andean Steppe	southern-andean-steppe
Southern Andean Yungas	southern-andean-yungas
Southern Annamites Montane Rainforests	southern-annamites-montane-rainforests
Southern Atlantic Brazilian Mangroves	southern-atlantic-brazilian-mangroves
Southern Cone Mesopotamian Savanna	southern-cone-mesopotamian-savanna
Southern Congolian Forest-Savanna	southern-congolian-forest-savanna
Southern Great Lakes Forests	southern-great-lakes-forests
Southern Hudson Bay Taiga	southern-hudson-bay-taiga
Southern Indian Ocean Islands Tundra	southern-indian-ocean-islands-tundra
Southern Korea Evergreen Forests	southern-korea-evergreen-forests
Southern Mesoamerican Pacific Mangroves	southern-mesoamerican-pacific-mangroves
Southern New Guinea Freshwater Swamp Forests	southern-new-guinea-freshwater-swamp-forests
Southern New Guinea Lowland Rainforests	southern-new-guinea-lowland-rainforests
Southern Pacific Dry Forests	southern-pacific-dry-forests
Southern Rift Montane Forest-Grassland	southern-rift-montane-forest-grassland
Southern Swahili Coastal Forests and Woodlands	southern-swahili-coastal-forests-and-woodlands
Southern Vietnam Lowland Dry Forests	southern-vietnam-lowland-dry-forests
Southwest Amazon Moist Forests	southwest-amazon-moist-forests
Southwest Arabian Coastal Xeric Shrublands	southwest-arabian-coastal-xeric-shrublands
Southwest Arabian Escarpment Shrublands and Woodlands	southwest-arabian-escarpment-shrublands-and-woodlands
Southwest Arabian Highland Xeric Scrub	southwest-arabian-highland-xeric-scrub
Southwest Arabian Montane Woodlands and Grasslands	southwest-arabian-montane-woodlands-and-grasslands
Southwest Australia Savanna	southwest-australia-savanna
Southwest Australia Woodlands	southwest-australia-woodlands
Southwest Borneo Freshwater Swamp Forests	southwest-borneo-freshwater-swamp-forests
Southwest Iberian Mediterranean Sclerophyllous and Mixed Forests	southwest-iberian-mediterranean-sclerophyllous-and-mixed-forests
Sri Lanka Dry-Zone Dry Evergreen Forests	sri-lanka-dry-zone-dry-evergreen-forests
Sri Lanka Lowland Rainforests	sri-lanka-lowland-rainforests
Sri Lanka Montane Rainforests	sri-lanka-montane-rainforests
St. Helena Scrub and Woodlands	st-helena-scrub-and-woodlands
St. Peter and St. Paul Rocks	st-peter-and-st-paul-rocks
Succulent Karoo Xeric Shrublands	succulent-karoo-xeric-shrublands
Sudd Flooded Grasslands	sudd-flooded-grasslands
Suiphun-Khanka Meadows and Forest Meadows	suiphun-khanka-meadows-and-forest-meadows
Sulaiman Range Alpine Meadows	sulaiman-range-alpine-meadows
Sulawesi Lowland Rainforests	sulawesi-lowland-rainforests
Sulawesi Montane Rainforests	sulawesi-montane-rainforests
Sulu Archipelago Rainforests	sulu-archipelago-rainforests
Sumatran Freshwater Swamp Forests	sumatran-freshwater-swamp-forests
Sumatran Lowland Rainforests	sumatran-lowland-rainforests
Sumatran Montane Rainforests	sumatran-montane-rainforests
Sumatran Peat Swamp Forests	sumatran-peat-swamp-forests
Sumatran Tropical Pine Forests	sumatran-tropical-pine-forests
Sumba Deciduous Forests	sumba-deciduous-forests
Sunda Shelf Mangroves	sunda-shelf-mangroves
Sundaland Heath Forests	sundaland-heath-forests
Sundarbans Freshwater Swamp Forests	sundarbans-freshwater-swamp-forests
Sundarbans Mangroves	sundarbans-mangroves
Syrian Xeric Grasslands and Shrublands	syrian-xeric-grasslands-and-shrublands
Taiheiyo Evergreen Forests	taiheiyo-evergreen-forests
Taiheiyo Montane Deciduous Forests	taiheiyo-montane-deciduous-forests
Taimyr-Central Siberian Tundra	taimyr-central-siberian-tundra
Taiwan Subtropical Evergreen Forests	taiwan-subtropical-evergreen-forests
Taklimakan Desert	taklimakan-desert
Talamancan Montane Forests	talamancan-montane-forests
Tamaulipan Matorral	tamaulipan-matorral
Tamaulipan Mezquital	tamaulipan-mezquital
Tapajós-Xingu Moist Forests	tapajos-xingu-moist-forests
Tarim Basin Deciduous Forests and Steppe	tarim-basin-deciduous-forests-and-steppe
Tasmanian Central Highland Forests	tasmanian-central-highland-forests
Tasmanian Temperate Forests	tasmanian-temperate-forests
Tasmanian Temperate Rainforests	tasmanian-temperate-rainforests
Tehuacán Valley Matorral	tehuacan-valley-matorral
Tenasserim-South Thailand Semi-Evergreen Rainforests	tenasserim-south-thailand-semi-evergreen-rainforests
Terai-Duar Savanna and Grasslands	terai-duar-savanna-and-grasslands
Texas Blackland Prairies	texas-blackland-prairies
Thar Desert	thar-desert
Tian Shan Foothill Arid Steppe	tian-shan-foothill-arid-steppe
Tian Shan Montane Conifer Forests	tian-shan-montane-conifer-forests
Tian Shan Montane Steppe and Meadows	tian-shan-montane-steppe-and-meadows
Tibesti-Jebel Uweinat Montane Xeric Woodlands	tibesti-jebel-uweinat-montane-xeric-woodlands
Tibetan Plateau Alpine Shrublands and Meadows	tibetan-plateau-alpine-shrublands-and-meadows
Tigris-Euphrates Alluvial Salt Marsh	tigris-euphrates-alluvial-salt-marsh
Timor and Wetar Deciduous Forests	timor-and-wetar-deciduous-forests
Tirari-Stuart Stony Desert	tirari-stuart-stony-desert
Tocantins/Pindare Moist Forests	tocantins-pindare-moist-forests
Tongan Tropical Moist Forests	tongan-tropical-moist-forests
Tonle Sap Freshwater Swamp Forests	tonle-sap-freshwater-swamp-forests
Tonle Sap-Mekong Peat Swamp Forests	tonle-sap-mekong-peat-swamp-forests
Torngat Mountain Tundra	torngat-mountain-tundra
Trans Fly Savanna and Grasslands	trans-fly-savanna-and-grasslands
Trans-Baikal Bald Mountain Tundra	trans-baikal-bald-mountain-tundra
Trans-Baikal Conifer Forests	trans-baikal-conifer-forests
Trans-Mexican Volcanic Belt Pine-Oak Forests	trans-mexican-volcanic-belt-pine-oak-forests
Transantarctic Mountains Tundra	transantarctic-mountains-tundra
Trindade-Martin Vaz Islands Tropical Forests	trindade-martin-vaz-islands-tropical-forests
Trinidad and Tobago Dry Forests	trinidad-and-tobago-dry-forests
Trinidad and Tobago Moist Forest	trinidad-and-tobago-moist-forest
Tristan Da Cunha-Gough Islands Shrub and Grasslands	tristan-da-cunha-gough-islands-shrub-and-grasslands
Trobriand Islands Rainforests	trobriand-islands-rainforests
Tuamotu Tropical Moist Forests	tuamotu-tropical-moist-forests
Tubuai Tropical Moist Forests	tubuai-tropical-moist-forests
Tumbes-Piura Dry Forests	tumbes-piura-dry-forests
Tyrrhenian-Adriatic Sclerophyllous and Mixed Forests	tyrrhenian-adriatic-sclerophyllous-and-mixed-forests
Uatumã-Trombetas Moist Forests	uatuma-trombetas-moist-forests
Ucayali Moist Forests	ucayali-moist-forests
Upper Gangetic Plains Moist Deciduous Forests	upper-gangetic-plains-moist-deciduous-forests
Upper Midwest US Forest-Savanna Transition	upper-midwest-us-forest-savanna-transition
Urals Montane Forest and Taiga	urals-montane-forest-and-taiga
Uruguayan Savanna	uruguayan-savanna
Ussuri Broadleaf and Mixed Forests	ussuri-broadleaf-and-mixed-forests
Valdivian Temperate Forests	valdivian-temperate-forests
Vanuatu Rainforests	vanuatu-rainforests
Venezuelan Andes Montane Forests	venezuelan-andes-montane-forests
Veracruz Dry Forests	veracruz-dry-forests
Veracruz Moist Forests	veracruz-moist-forests
Veracruz Montane Forests	veracruz-montane-forests
Victoria Basin Forest-Savanna	victoria-basin-forest-savanna
Victoria Plains Tropical Savanna	victoria-plains-tropical-savanna
Vogelkop Montane Rainforests	vogelkop-montane-rainforests
Vogelkop-Aru Lowland Rainforests	vogelkop-aru-lowland-rainforests
Wasatch and Uinta Montane Forests	wasatch-and-uinta-montane-forests
Watson Highlands Taiga	watson-highlands-taiga
West Sahara Desert	west-sahara-desert
West Saharan Montane Xeric Woodlands	west-saharan-montane-xeric-woodlands
West Siberian Taiga	west-siberian-taiga
West Sudanian Savanna	west-sudanian-savanna
Western Australian Mulga Shrublands	western-australian-mulga-shrublands
Western Congolian Forest-Savanna	western-congolian-forest-savanna
Western Congolian Swamp Forests	western-congolian-swamp-forests
Western Ecuador Moist Forests	western-ecuador-moist-forests
Western European Broadleaf Forests	western-european-broadleaf-forests
Western Great Lakes Forests	western-great-lakes-forests
Western Guinean Lowland Forests	western-guinean-lowland-forests
Western Gulf Coastal Grasslands	western-gulf-coastal-grasslands
Western Himalayan Alpine Shrub and Meadows	western-himalayan-alpine-shrub-and-meadows
Western Himalayan Broadleaf Forests	western-himalayan-broadleaf-forests
Western Himalayan Subalpine Conifer Forests	western-himalayan-subalpine-conifer-forests
Western Java Montane Rainforests	western-java-montane-rainforests
Western Java Rainforests	western-java-rainforests
Western Polynesian Tropical Moist Forests	western-polynesian-tropical-moist-forests
Western Shortgrass Prairie	western-shortgrass-prairie
Western Siberian Hemiboreal Forests	western-siberian-hemiboreal-forests
Westland Temperate Forests	westland-temperate-forests
Willamette Valley Oak Savanna	willamette-valley-oak-savanna
Windward Islands Moist Forests	windward-islands-moist-forests
Wrangel Island Arctic Desert	wrangel-island-arctic-desert
Wyoming Basin Shrub Steppe	wyoming-basin-shrub-steppe
Xingu-Tocantins-Araguaia Moist Forests	xingu-tocantins-araguaia-moist-forests
Yamal-Gydan Tundra	yamal-gydan-tundra
Yap Tropical Dry Forests	yap-tropical-dry-forests
Yapen Rainforests	yapen-rainforests
Yarlung Zanbo Arid Steppe	yarlung-zanbo-arid-steppe
Yellow Sea Saline Meadow	yellow-sea-saline-meadow
Yucatan Dry Forests	yucatan-dry-forests
Yucatan Moist Forests	yucatan-moist-forests
Yunnan Plateau Subtropical Evergreen Forests	yunnan-plateau-subtropical-evergreen-forests
Zagros Mountains Forest Steppe	zagros-mountains-forest-steppe
Zambezian Baikiaea Woodlands	zambezian-baikiaea-woodlands
Zambezian Coastal Flooded Savanna	zambezian-coastal-flooded-savanna
Zambezian Evergreen Dry Forests	zambezian-evergreen-dry-forests
Zambezian Flooded Grasslands	zambezian-flooded-grasslands
Zambezian Mopane Woodlands	zambezian-mopane-woodlands
Zambezian-Limpopo Mixed Woodlands	zambezian-limpopo-mixed-woodlands
